##########
#        #
# O H O  #
#  ##    #
# .  .   #
##########
