#########
#       #
# O ##O #
# .#  . #
## HO ###
#  .#   #
# O #   #
#      .#
#########