#########
#   #   #
# O # O #
# . # . #
###   ###
#  H O  #
#   .   #
#########