########
###   ##
#. HO ##
### O.##
#.##O ##
# # . ##
#OO.OO.#
#   .  #
########
