########
#  #   #
# O .. #
# ##O# #
#  H   #
# #O## #
# .. O #
#      #
########
