        #####    
        #   #####
        # #O##  #
        #     O #
######### ###   #
#....  ## O  O###
#....    O OO ## 
#....  ##O  O H# 
#########  O  ## 
        # O O  # 
        ### ## # 
          #    # 
          ######
