############
#  #       #
#  # O O # #
#  #.# #.# #
## H     # #
#  ### O # #
#    #.    #
############