########
#H     #
###### #
#      #
# ######
#      #
###### #
#.O    #
########
